###########################################################
#............................................#............#
#............................................#..........AT#
#....................#.......................#............#
#....................#.......................#............#
#....................#....................................#
######################....................................#
#....................................#####.################
#....................................#   #.#               
#....................................#  ##.#############   
###########################.##########  #..............#   
                          #.#           #..............#   
                          #.#        ####..............#   
                          #.#        #.................#   
                   ########.##########.................#   
    #############  #...................#################   
    #...........####...................#                   
    #..............................#####  ###############  
    #..............................#      #.............#  
    #...........####...............#      #.............#  
    #...........#  #...............#      #.............#  
    #...........#  ############.####      ###########.###  
    #...........#             #.#                   #.#    
    #...........############  #.#####################.#    
    #......................#  #.......................#    
    #......................#  #.......................#    
    #...........###........#  #....................####    
    #...........# #........#  #....................#       
    #...........# #........#  #....................#       
    ############# #.############...................#       
                  #..............###################       
                  #..............#                         
                  ################                         
                                                           
