5__________________7
/HHHHHHHHHHHHHHHHHH\
/..................\
/..................\
/..................\
/..................\
/..................\
/..................\
/..................\
L------------------l
....................
