##########################################################
#...............#.........#..............................#
#...............#.........#..............................#
#...............#.........#..............................#
##############.###.########..............................#
#........................................................#
#........................................................#
#........................................................#
#........................................................#
#........................................................#
#........................................................#
#######..................................................#
......#..................................................#
......#..................................................#
......#..................................................#
......#..................................................#
......#..................................................#
......#..................................................#
......#..................................................#
......#......................................#############
......##..##################################.#............
......#........................#...........#.#............
......#....................................#.#............
......#........................#...........#.#............
......#........................#...........#.#............
......#........................#############.#............
......#......................................#............
......#........................###############............
......#........................#..........................
......#........................#..........................
......#........................#..........................
......##########################..........................
