##########################################################
#...............#.........#..............................#
#...............#.........#..............................#
#...............#.........#..............................#
##############.###.########..............................#
#........................................................#
#........................................................#
#........................................................#
#........................................................#
#........................................................#
#........................................................#
#######..................................................#
......#..................................................#
......#..................................................#
......#..................................................#
......#..................................................#
......#..................................................#
......#..................................................#
......#..................................................#
......#......................................#############
......##..##################################.#
......#........................#...........#.#
......#....................................#.#
......#........................#...........#.#
......#........................#...........#.#
......#........................#############.#
......#......................................#
......#........................###############
......#........................#
......#........................#
......#........................#
......##########################
