5____________7
/HHHHHHHHHHHH\
/............\
/___6........\
/HHHH........\
/............\
/___6........\
/HHHH........\
/............\
L---M........\
****/........\
^^^^/........\
^^^^/........\
^^^^/........\
^^^^/........\
^^^^/........\
^^^^/........\
^^^^/........\
^^^^/........\
^^^^/........\
^^^^/........\
^^^^/........\
^^^^/........\
^^^^/........\
/............\
/............\
/............\
/............\
/............\
L------------l
..............
